11111111111111111111111111111
10P00000010000100000000100001
1000000001000010000000000E001
1000000000000010C000000111111
10000000010000000000000000001
10000000010000100000000000001
10000000010000100000000000001
10000000010000100000000000001
1000000C0000000C0000000000001
11111111111111111111111111111