11111111111111111
10011C1000000E0P1
101C1000000000011
10110000000000001
10100000000000001
11111111111111111