11111111111111111
10001C1000000E1P1
100C0000000000011
10100000000000001
10100000000000001
11111111111111111