11111111
1C000001
100C00E1
11111111
