11111111
1C000001
1P0C00E1
11101111
