11111111
1C000001
1P0C0PE1
11111111
