11111111
1CE00001
1P0C00E1
11111111
