11111111
1C000001
1P0C0001
11111111
