1111111111
1E1C000011
1010000011
1000000001
1001010001
10s1P10001
1001110001
1000000001
1111111111