11111111111111111
1C0000P0000000EC1
11111111111111111








