11111111111111111
10C0000000000E0P1
10000000000000011
1010000C000C00001
1C100000000000001
11111111111111111
