1111111111
1000000001
1000000001
1000000001
1000P00001
1000000001
1000000001
1000000001
1000C000E1
1111111111
